Precinct,County,Registered Voters,Shelly J. Bishop (I) (Rep)_Election Day Votes,Shelly J. Bishop (I) (Rep)_Advanced Voting Votes,Shelly J. Bishop (I) (Rep)_Absentee by Mail Votes,Shelly J. Bishop (I) (Rep)_Provisional Votes,Shelly J. Bishop (I) (Rep)_Choice Total,Total,
Colwell,Fannin,1105,285,316,143,0,744,744,
Fairplay,Fannin,1262,308,329,127,0,764,764,
Flinthill,Fannin,3202,655,834,387,1,1877,1877,
Hemptown,Fannin,1336,347,353,149,3,852,852,
Hothouse,Fannin,1290,268,388,162,7,825,825,
Mineral Bluff,Fannin,1817,337,600,246,0,1183,1183,
Mobile,Fannin,1160,303,291,143,0,737,737,
Morganton,Fannin,2067,469,603,260,2,1334,1334,
Noontootla,Fannin,839,185,243,154,0,582,582,
Skeniah,Fannin,331,117,65,47,2,231,231,
Sugar Creek,Fannin,2437,388,848,302,1,1539,1539,
Toccoa,Fannin,3553,498,1188,483,4,2173,2173,
